NO ./texture/ray/no.xpm
SO ./texture/ray/so.xpm
WE ./texture/ray/we.xpm
EA ./texture/ray/ea.xpm

F 220,100,1
C 225,30,0

1111111111111111111111111
1000000000000000000000001
100000C000000000C00000001
1000C00000000000C000C0001
10P00000C0000000000000001
1000C00000000000C00000001
1000000C00000000000000001
10000000000000000000C00E1
1111111111111111111111111
