NO ./texture/ray/no.xpm
SO ./texture/ray/so.xpm
WE ./texture/ray/we.xpm
EA ./texture/ray/ea.xpm

F 0,50,12
C 0,100,0


           111111111
           1000H0001
           100000001
           10000N001
       11111111B11111111
       10000000000000001
       10000000000000001
       11111111011111111
              101
              101
              101
              101
1111111111111110111111111111111
1000000000000000000000000100001
1000000001100000000000000B00001
100111111000000000000000011B111
1000000000000001110000000000001
1000000000110000000000000000001
1000111110000000000001000111001
1000000000000000011110011110001
1001111000001111100000100001001
1000000000001100000000B00001001
1000000111110110000000011110001
1001000000001001000000000000001
100010000001000B000000000000001
1000010000001111000000000000001
1000001100000000000000000000001
1000000010000000000000001100001
1000000100000000000000010010001
1000011000000000001111100001101
1000000000000000000000000000001
1111111111111111111111111111111
