1111111111111
1CM10000000C1
1000011111M01
1P0M11E0000C1
1111111111111