1111111111111
1EC10000000C1
1CC0011111001
1P011100000C1
1111111111111