1111111111111
1PCE000000011
1111111111111