1111111111111
1PC000E0000C1
1111111111111