1111111111111111111111111111111111
1P0010000000C00000000000000000C001
1000100000000000C00000000010000001
1100100000000000000000000010C00001
1100000000000000000000000011111101
1100000000000000C00000000011000101
10000000000000000000000001E1010101
1000000000000000000000000101010101
1000000000C0000000000C000101010101
1000000000000000000000000100010001
1111111111111111111111111111111111