1111111111111
1P000000000C1
1111101111111
1111101100001
11111E1100001
1111111111111

1111111111111
1000000000011
1111111111111